rock8.png stone.png
2
Portal
160 640 160 640 roomnx.txt 
Player
_______________________________________
_______________________________________
_______________________________________
_______________________________________
_______________________________________
_______________________________________
____________________________________...
_____..................................
_____..................................
_____..................................
_____..................................
_____..............................__._
_____................................._
_____...........................__...._
_____.......................__........_
_____................................__
_____..........___________..........___
_____........._____________......._____
_____...0....._____________......______
_______________________________________
_______________________________________
_______________________________________
_______________________________________
