1
Player
_______________________________________
_______________________________________
_______________________________________
_______________________________________
_______________________________________
_______________________________________
____________________________________...
_____..................................
_____..................................
_____..................................
_____.................................0
_____..............................__._
_____................................._
_____...........................__...._
_____.......................__........_
_____................................__
_____..........___________..........___
_____........._____________......._____
_____0........_____________......______
_______________________________________
_______________________________________
_______________________________________
_______________________________________
