rock8.png stone.png

1
RestCrystal 472 768

2
-16 704 16 64 2.txt 0 1
944 704 32 64 2.txt 1 0
1
672 768 Abil.txt 2
___________________________________________________________
___________________________________________________________
___________________________________________________________
___________________________________________________________
___________________________________________________________
___________________________________________________________
___________________________________________________________
___________________________________________________________
___________________________________________________________
___________________________________________________________
___________________________________________________________
___________________________________________________________
___________________________________________________________
___________________________________________________________
___________________________________________________________
___________________________________________________________
___________________________________________________________
___________________________________________________________
___________________________________________________________
___________________________________________________________
___________________________________________________________
___________________________________________________________
___________________________________________________________
___________________________________________________________
___________________________________________________________
___________________________________________________________
___________________________________________________________
___________________________________________________________
___________________________________________________________
___________________________________________________________
___________________________________________________________
___________________________________________________________
_________________________............______________________
_______________________..............._____________________
_____________________..................____________________
____________________....................___________________
__________________.......................__________________
_________________........................._________________
________________...........................________________
_______________............................._______________
______________...............................______________
_____________................................._____________
____________...................................____________
___________............................................____
...........................................................
...........................................................
...........................................................
...........................................................
___________________________________________________________
___________________________________________________________
___________________________________________________________
___________________________________________________________
___________________________________________________________
___________________________________________________________
