rock8.png stone.png
38
Enep 184 800
Enep 200 800
Enep 216 800
Enep 232 800
Enep 248 800
Enep 264 800
Enep 280 800
Enep 296 800
Enep 312 800
Enep 328 800
Enep 344 800
Enep 360 800
Enep 376 800
Enep 408 800
Enep 392 800
Enep 424 800
Enep 440 800
Enep 456 800
Enep 472 800
Enep 776 800
Enep 760 800
Enep 744 800
Enep 552 800
Enep 504 800
Enep 520 800
Enep 536 800
Enep 488 800
Enep 664 800
Enep 648 800
Enep 632 800
Enep 616 800
Enep 600 800
Enep 584 800
Enep 568 800
Enep 680 800
Enep 696 800
Enep 712 800
Enep 728 800
2
-16 704 16 64 1.txt 1 1
944 704 32 64 1.txt 0 0
0
___________________________________________________________
___________________________________________________________
___________________________________________________________
___________________________________________________________
___________________________________________________________
___________________________________________________________
___________________________________________________________
___________________________________________________________
___________________________________________________________
___________________________________________________________
___________________________________________________________
___________________________________________________________
___________________________________________________________
___________________________________________________________
___________________________________________________________
___________________________________________________________
___________________________________________________________
___________________________________________________________
___________________________________________________________
___________________________________________________________
___________________________________________________________
___________________________________________________________
___________________________________________________________
___________________________________________________________
___________________________________________________________
___________________________________________________________
___________________________________________________________
___________________________________________________________
___________________________________________________________
___________________________________________________________
___________________________________________________________
___________......................................__________
___________......................................__________
___________......................................__________
___________......................................__________
___________......................................__________
___________......................................__________
___________......................................__________
___________......................................__________
___________......................................__________
___________......................................__________
___________......................................__________
___________......................................__________
___________............................................____
...........................................................
...........................................................
...........................................................
...........................................................
___________......................................__________
___________......................................__________
___________________________________________________________
___________________________________________________________
___________________________________________________________
___________________________________________________________
___________________________________________________________
___________________________________________________________
___________________________________________________________
___________________________________________________________
___________________________________________________________
___________________________________________________________
___________________________________________________________
___________________________________________________________
___________________________________________________________
___________________________________________________________
___________________________________________________________
___________________________________________________________
___________________________________________________________
___________________________________________________________
___________________________________________________________
___________________________________________________________
___________________________________________________________
___________________________________________________________
___________________________________________________________
___________________________________________________________
___________________________________________________________
___________________________________________________________
___________________________________________________________
