rock8.png stone.png
1
Paper_jump 1267 571
1
1952 336 48 64 01.txt 0 0
0
__________________________________________________________________________________________________________________________
__________________________________________________________________________________________________________________________
__________________________________________________________________________________________________________________________
__________________________________________________________________________________________________________________________
__________________________________________________________________________________________________________________________
__________________________________________________________________________________________________________________________
__________________________________________________________________________________________________________________________
__________________________________________________________________________________________________________________________
__________________________________________________________________________________________________________________________
__________________________________________________________________________________________________________________________
__________________________________________________________________________________________________________________________
__________________________________________________________________________________________________________________________
__________________________________________________________________________________________________________________________
__________________________________________________________________________________________________________________________
__________________________________________________________________________________________________________________________
__________________________________________________________________________________________________________________________
__________________________________________________________________________________________________________________________
__________________________________________________________________________________________________________________________
____________________________________________________________............................................................._
____________________________________________________________............................................................._
____________________________________________________________............................................................._
____________________________________________________________..............................................................
________________.................................___________..............................................................
________________.................................___________..............................................................
________________.................................___________..............................................................
________________.................................___________........................................._____________________
________________.................................___________........................................._____________________
________________.................................___________........................................._____________________
________________.................................___________........................................._____________________
________________.................................___________........................................._____________________
________________.................................___________........................................._____________________
________________....................................................................................._____________________
________________..................................................................................________________________
________________..................................................................................________________________
________________..................................................................................________________________
________________..................................................................................________________________
________________..................................................................................________________________
________________..................................................................................________________________
________________..................................................................................________________________
__________________________________________________________________________________________________________________________
__________________________________________________________________________________________________________________________
__________________________________________________________________________________________________________________________
__________________________________________________________________________________________________________________________
__________________________________________________________________________________________________________________________
__________________________________________________________________________________________________________________________
