rock8.png stone.png
1
RestCrystal 744 528
2
1424 288 32 64 3.txt 3 0
-32 464 32 64 5.txt 4 1
0
_________________________________________________________________________________________
_________________________________________________________________________________________
_________________________________________________________________________________________
_________________________________________________________________________________________
_________________________________________________________________________________________
_________________________________________________________________________________________
_________________________________________________________________________________________
_________________________________________________________________________________________
_________________________________________________________________________________________
_________________________________________________________________________________________
_________________________________________________________________________________________
_________________________________________________________________________________________
_________________________________________________________________________________________
_________________________________________________________________________________________
_________________________________________________________________________________________
_________________________________________________________________________________________
_________________________________________________________________________________________
_________________________________________________________________________________________
__________________________...............................................................
________________________.................................................................
_______________________..................................................................
______________________...................................................................
______________________...................................................._______________
_____________________....................................................._______________
_____________________....................................................._______________
_____________________....................................................._______________
_____________________....................................................._______________
_____________________....................................................._______________
_____________________....................................................________________
.........................................................................________________
........................................................................_________________
.......................................................................__________________
.....................................................................____________________
_________________________________________________________________________________________
_________________________________________________________________________________________
_________________________________________________________________________________________
_________________________________________________________________________________________
_________________________________________________________________________________________
_________________________________________________________________________________________
