rock8.png stone.png
4
Crystal 1000 592
Enep 1400 688
Enep 344 688
Enep 744 688
2
1808 592 48 64 4.txt 4 0
-48 560 48 64 6.txt 5 1
0
_________________________________________________________________________________________________________________
_________________________________________________________________________________________________________________
_________________________________________________________________________________________________________________
_________________________________________________________________________________________________________________
_________________________________________________________________________________________________________________
_________________________________________________________________________________________________________________
_________________________________________________________________________________________________________________
_________________________________________________________________________________________________________________
_________________________________________________________________________________________________________________
_________________________________________________________________________________________________________________
_________________________________________________________________________________________________________________
_________________________________________________________________________________________________________________
_________________________________________________________________________________________________________________
_________________________________________________________________________________________________________________
_________________________________________________________________________________________________________________
_________________________________________________________________________________________________________________
_________________________________________________________________________________________________________________
_________________________________________________________________________________________________________________
_________________________________________________________________________________________________________________
_______......................................................____________________________________________________
_______......................................................____________________________________________________
_______......................................................____________________________________________________
_______......................................................____________________________________________________
_______......................................................____________________________________________________
_______......................................................____________________________________________________
_______......................................................____________________________________________________
_______......................................................____________________________________________________
_______....................................................................................................______
_______....................................................................................................______
_______....................................................................................................______
_______....................................................................................................______
_______....................................................................................................______
_______....................................................................................................______
_______....................................................................................................______
______.....................................................................................................______
...........................................................................................................______
...........................................................................................................______
........................................................______________...........................................
........................................................______________...........................................
______..................................................______________...........................................
_______.................................................______________...........................................
_______.................................................______________.....................................______
_______.................................................______________.....................................______
_________________________________________________________________________________________________________________
_________________________________________________________________________________________________________________
_________________________________________________________________________________________________________________
_________________________________________________________________________________________________________________
_________________________________________________________________________________________________________________
_________________________________________________________________________________________________________________
_________________________________________________________________________________________________________________