rock8.png stone.png
21
Spike 856 528
Spike 872 528
Spike 888 528
Spike 904 528
Spike 920 528
Spike 936 528
Spike 952 528
Spike 968 528
Spike 984 528
Spike 1000 528
Spike 1016 528
Spike 1032 528
Spike 1048 528
Spike 1064 528
Spike 1080 528
Spike 1096 528
Spike 1112 528
Spike 1128 528
Spike 1144 528
Spike 1160 528
Spike 1176 528
1
1328 400 48 64 6.txt 6 0
1
464 464 0.txt 7
___________________________________________________________________________________
___________________________________________________________________________________
___________________________________________________________________________________
___________________________________________________________________________________
___________________________________________________________________________________
___________________________________________________________________________________
___________________________________________________________________________________
___________________________________________________________________________________
___________________________________________________________________________________
___________________________________________________________________________________
___________________________________________________________________________________
___________________________________________________________________________________
___________________________________________________________________________________
___________________________________________________________________________________
___________________________________________________________________________________
___________________________________________________________________________________
_______________________..........__________________________________________________
___________________................._______________________________________________
__________________.....................____________________________________________
________________.........................__________________________________________
________________...........................____________................____________
_______________.............................________.....................__________
_______________..............................______........................________
_______________...............................___..........................._______
______________.................................................................____
______________.....................................................................
______________.....................................................................
______________..............................................._____.................
______________.....................................................................
_____________________________________________________....................._________
_____________________________________________________....................._________
_____________________________________________________....................._________
_____________________________________________________....................._________
___________________________________________________________________________________
___________________________________________________________________________________
___________________________________________________________________________________
___________________________________________________________________________________
___________________________________________________________________________________
___________________________________________________________________________________
