rock8.png stone.png
3
Enep 1208 512
Enep 1400 512
Enep 568 608
2
1584 416 32 64 2.txt 1 0
-32 512 32 64 02.txt 0 1
0
___________________________________________________________________________________________________
___________________________________________________________________________________________________
___________________________________________________________________________________________________
___________________________________________________________________________________________________
___________________________________________________________________________________________________
___________________________________________________________________________________________________
___________________________________________________________________________________________________
___________________________________________________________________________________________________
___________________________________________________________________________________________________
___________________________________________________________________________________________________
___________________________________________________________________________________________________
___________________________________________________________________________________________________
___________________________________________________________________________________________________
___________________________________________________________________________________________________
___________________________________________________________________________________________________
___________________________________________________________________________________________________
______________________________________________________________...................................._
______________________________________________________________...................................._
______________________________________________________________...................................._
______________________________________________________________...................................._
______________________________________________________________...................................._
______________________________________________________________...................................._
_______________.......................................________...................................._
_______________.......................................________...................................._
_______________.......................................________...................................._
_______________.......................................________...................................._
_______________....................................................................................
_______________....................................................................................
_______________....................................................................................
_______________....................................................................................
_______________.......................................________...................................__
_.....................................................________...................................__
......................................................_____________________________________________
......................................................_____________________________________________
......................................................_____________________________________________
.................................................__________________________________________________
_____________________............................__________________________________________________
_____________________............................__________________________________________________
___________________________________________________________________________________________________
___________________________________________________________________________________________________
___________________________________________________________________________________________________
___________________________________________________________________________________________________
___________________________________________________________________________________________________
