rock8.png stone.png
25
Spike 424 352
Spike 440 352
Spike 456 352
Spike 472 352
Spike 488 352
Spike 504 352
Spike 520 352
Spike 536 352
Spike 552 352
Spike 568 352
Spike 584 352
Spike 600 352
Spike 616 352
Spike 632 352
Spike 648 352
Spike 664 352
Spike 680 352
Spike 696 352
Spike 712 352
Spike 728 352
Spike 744 352
Spike 760 352
Spike 776 352
Spike 792 352
Spike 808 352
2
-48 896 48 64 1.txt 1 1
880 176 32 80 3.txt 0 0
0
_______________________________________________________
_______________________________________________________
_______________________________________________________
_______________________________________________________
_______________________________________________________
_______________________________________________________
_______________________________________________________
__________________________.........................____
_________________________..........................____
_________________________..........................____
________________________.............................__
________________________...............................
_____________..........................................
____________...........................................
____________...........................................
____________...........................................
____________......._______.........________........____
____________......________.........................____
____________....._________.........................____
____________....._________.........................____
____________....__________.........................____
____________....._________.........................____
____________.....______________________________________
____________.....______________________________________
____________.....______________________________________
____________.....______________________________________
____________.....______________________________________
_____________....______________________________________
____________.....______________________________________
____________.....______________________________________
____________.....______________________________________
____________.....______________________________________
____________.....______________________________________
____________...._______________________________________
____________.....______________________________________
____________.....______________________________________
____________.....______________________________________
_____________....______________________________________
____________.....______________________________________
____________.....______________________________________
___________......______________________________________
___________....._______________________________________
___________......______________________________________
___________......______________________________________
___________......______________________________________
___________......______________________________________
___________......______________________________________
___________......______________________________________
____________.....______________________________________
___________......______________________________________
__________.......______________________________________
__________.......______________________________________
_________........______________________________________
________.........______________________________________
______.........._______________________________________
___............._______________________________________
...............________________________________________
...............________________________________________
.............._________________________________________
.............__________________________________________
_______________________________________________________
_______________________________________________________
_______________________________________________________
_______________________________________________________
_______________________________________________________
