rock8.png stone.png
2
RestCrystal 264 480
Paper_sword&shield 408 1008
2
-48 976 48 64 2.txt 0 1
-64 368 64 64 4.txt 1 1
0
________________________________________________________
________________________________________________________
________________________________________________________
________________________________________________________
________________________________________________________
________________________________________________________
________________________________________________________
________________________________________________________
________________________________________________________
________________________________________________________
________________________________________________________
________________________________________________________
________________________________________________________
____________................................____________
____________................................____________
____________................................____________
____________................................____________
____________................................____________
____________................................____________
____________................................____________
____________................................____________
____________................................____________
____________................................____________
............................................____________
............................................____________
............................................____________
............................................____________
____________................................____________
____________................................____________
____________................................____________
_______________________.........._______________________
_______________________.........._______________________
________________________........._______________________
_______________________.........._______________________
_______________________.........._______________________
_______________________.........._______________________
_______________________.........._______________________
_______________________.........._______________________
_______________________.........._______________________
_______________________.........._______________________
_______________________.........._______________________
_______________________.........________________________
_______________________.........._______________________
_______________________.........._______________________
_______________________.........._______________________
_______________________.........._______________________
_______________________.........._______________________
_______________________.........._______________________
_______________________.........._______________________
_______________________.........._______________________
________________________........._______________________
_______________________.........._______________________
_______________________.........._______________________
_______________________.........._______________________
_______________________.........._______________________
_______________________.........._______________________
_______________________.........._______________________
_______________________.........._______________________
_______________________.........._______________________
_______________________.........________________________
_______________________.........._______________________
................................._______________________
................................._______________________
................................._______________________
................................._______________________
________________________________________________________
________________________________________________________
________________________________________________________
________________________________________________________
________________________________________________________
________________________________________________________
________________________________________________________
