rock8.png stone.png
3
RestCrystal 328 288
Paper_jump 984 672
Crystal 1128 704
2
1536 480 64 64 1.txt 0 0
-80 224 80 64 7.txt 7 1
0
________________________________________________________________________________________________
________________________________________________________________________________________________
________________________________________________________________________________________________
________________________________________________________________________________________________
________________________________________________________________________________________________
________________________________________________________________________________________________
________________________________________________________________________________________________
________________________________________________________________________________________________
________________________________________________________________________________________________
______________............._____________________________________________________________________
_____________...............____________________________________________________________________
____________.................___________________________________________________________________
____________.................___________________________________________________________________
____________.................___________________________________________________________________
.....................................___________________________________________________________
.....................................___________________________________________________________
.....................................___________________________________________________________
.....................................___________________________________________________________
__________________________________...___________________________________________________________
__________________________________...___________________________________________________________
__________________________________...___________________________________________________________
__________________________________...___________________________________________________________
__________________________________...___________________________________________________________
__________________________________...___________________________________________________________
__________________________________...___________________________________________________________
__________________________________...___________________________________________________________
__________________________________...___________________________________________________________
__________________________________...___________________________________________________________
__________________________________...___________________________________________________________
__________________________________...___________________________________________________________
__________________________________..._____________________......................................
__________________________________..._____________________......................................
__________________________________..._____________________......................................
__________________________________..._____________________......................................
__________________________________..................______............................__________
__________________________________..................______............................__________
__________________________________..................______............................__________
__________________________________..................______............................__________
__________________________________..................______............................__________
__________________________________..................______............................__________
__________________________________................................................______________
__________________________________................................................______________
__________________________________................................................______________
__________________________________................................................______________
________________________________________________________________________________________________
________________________________________________________________________________________________
________________________________________________________________________________________________
________________________________________________________________________________________________
