rock8.png stone.png
2
Spear 392 608
Tablet_danger 712 608
2
1408 528 64 64 3.txt 8 0
-64 528 64 64 9.txt 10 1
1
784 608 11.txt 9
________________________________________________________________________________________
________________________________________________________________________________________
________________________________________________________________________________________
________________________________________________________________________________________
________________________________________________________________________________________
________________________________________________________________________________________
________________________________________________________________________________________
________________________________________________________________________________________
________________________________________________________________________________________
________________________________________________________________________________________
________________________________________________________________________________________
________________________________________________________________________________________
_______.........................................................................._______
_______.........................................................................._______
_______.........................................................................._______
_______.........................................................................._______
_______.........................................................................._______
_______.........................................................................._______
_______.........................................................................._______
_______.........................................................................._______
_______.........................................................................._______
_______.........................................................................._______
_______.........................................................................._______
_______.........................................................................._______
_______.........................................................................._______
_______.........................................................................._______
_______.........................................................................._______
_______.........................................................................._______
_______.........................................................................._______
_______.........................................................................._______
_______.........................................................................._______
_______.........................................................................._______
_______.........................................................................._______
........................................................................................
........................................................................................
........................................................................................
........................................................................................
_______.........................................................................._______
________________________________________________________________________________________
________________________________________________________________________________________
________________________________________________________________________________________
________________________________________________________________________________________
