rock8.png stone.png
2
RestCrystal 392 496
Paper_STOM 616 464
2
848 400 32 64 8.txt 10 0
-32 400 32 64 10.txt 11 1
0
_____________________________________________________
_____________________________________________________
_____________________________________________________
_____________________________________________________
_____________________________________________________
_____________________________________________________
_____________________________________________________
_____________________________________________________
_____________________________________________________
_____________________..............__________________
__________________......................_____________
________________..........................___________
______________.............................._________
_____________................................._______
____________...................................______
___________....................................._____
__________......................................_____
__________.......................................____
__________.......................................____
__________.......................................____
__________.......................................____
__________.......................................____
__________.......................................____
__________.......................................____
__________.......................................____
.....................................................
.....................................................
.....................................................
.....................................................
___________....................................._____
__________._..................................._.____
_____________________________________________________
_____________________________________________________
_____________________________________________________
_____________________________________________________
_____________________________________________________
_____________________________________________________
